############################
#..........................#
#.................#........#
#..........................#
#..........................#
#..........................#
#.....#....................#
#..........................#
#..........................#
#..........................#
#..........................#
#..........................#
#..........................#
############################